nähmen wir dich ab?	abnehmen SBJV;LGSPEC1;NOM(1,PL);ACC(2,SG);Q
es werde uns sich abnehmen?	abnehmen QUOT;FUT;NOM(3,SG,NEUT);ACC(1,PL);DAT(3,SG,NEUT,RFLX)
er nimmt mich euch nicht ab.	abnehmen IND;PRS;NOM(3,SG,MASC);ACC(1,SG);DAT(2,PL);NEG
hätte sie mich Ihnen nicht abgenommen?	abnehmen SBJV;PRF;NOM(3,SG,FEM);ACC(1,SG);DAT(2,FORM);NEG;Q
nahmen wir sie uns ab?	abnehmen IND;PST;LGSPEC1;NOM(1,PL);ACC(3,PL);DAT(1,PL);Q
wir haben euch ihr abgenommen?	abnehmen QUOT;PST;NOM(1,PL);ACC(2,PL);DAT(3,SG,FEM)
sie nimmt euch sich ab.	abnehmen IND;PRS;NOM(3,SG,FEM);ACC(2,PL);DAT(3,SG,FEM,RFLX)
wird sie dich ihr nicht abnehmen?	abnehmen IND;FUT;NOM(3,SG,FEM);ACC(2,SG);DAT(3,SG,FEM);NEG;Q
habe er sie Ihnen nicht abgenommen?	abnehmen QUOT;PST;NOM(3,SG,MASC);ACC(3,PL);DAT(2,FORM);NEG;Q
ich hätte sie dir abgenommen.	abnehmen SBJV;PRF;NOM(1,SG);ACC(3,PL);DAT(2,SG)
sie nimmt es sich ab.	abnehmen IND;PRS;NOM(3,SG,FEM);ACC(3,SG,NEUT);DAT(3,SG,FEM,RFLX)
nehmen wir es dir nicht ab!	abnehmen IMP;NOM(1,PL);ACC(3,SG,NEUT);DAT(2,SG);NEG
er nimmt sich mir ab.	abnehmen IND;PRS;NOM(3,SG,MASC);ACC(3,SG,MASC,RFLX);DAT(1,SG)
nehmt ihr dich ihm nicht ab?	abnehmen IND;PRS;NOM(2,PL);ACC(2,SG);DAT(3,SG,MASC);NEG;Q
es werde sie dir nicht abgenommen haben?	abnehmen QUOT;FUT;PRF;NOM(3,SG,NEUT);ACC(3,SG,FEM);DAT(2,SG);NEG
werde er uns nicht abnehmen?	abnehmen QUOT;FUT;NOM(3,SG,MASC);ACC(1,PL);NEG;Q
nahm ich uns ihr ab?	abnehmen IND;PST;LGSPEC1;NOM(1,SG);ACC(1,PL);DAT(3,SG,FEM);Q
es nimmt sie uns ab.	abnehmen IND;PRS;NOM(3,SG,NEUT);ACC(3,SG,FEM);DAT(1,PL)
es nimmt ihn ihr nicht ab.	abnehmen IND;PRS;NOM(3,SG,NEUT);ACC(3,SG,MASC);DAT(3,SG,FEM);NEG
nahmen sie uns nicht ab?	abnehmen IND;PST;LGSPEC1;NOM(3,PL);ACC(1,PL);NEG;Q
ich nahm dich dir nicht ab.	abnehmen IND;PST;LGSPEC1;NOM(1,SG);ACC(2,SG);DAT(2,SG);NEG
nehmen wir es mir nicht ab?	abnehmen QUOT;PRS;NOM(1,PL);ACC(3,SG,NEUT);DAT(1,SG);NEG;Q
hat er mich von ihnen nicht abgesetzt?	absetzen IND;PST;NOM(3,SG,MASC);ACC(1,SG);AT+ABL(3,PL);NEG;Q
sie habe uns von ihm nicht abgesetzt?	absetzen QUOT;PST;NOM(3,SG,FEM);ACC(1,PL);AT+ABL(3,SG,NEUT);NEG
werde er uns von sich nicht abgesetzt haben?	absetzen QUOT;FUT;PRF;NOM(3,SG,MASC);ACC(1,PL);AT+ABL(3,SG,MASC,RFLX);NEG;Q
du setztest dich von ihr nicht ab.	absetzen IND;PST;LGSPEC1;NOM(2,SG);ACC(2,SG);AT+ABL(3,SG,FEM);NEG
setzten Sie euch von sich nicht ab?	absetzen SBJV;LGSPEC1;NOM(2,FORM);ACC(2,PL);AT+ABL(2,FORM,RFLX);NEG;Q
es setze Sie ab?	absetzen QUOT;PRS;NOM(3,SG,NEUT);ACC(2,FORM)
